


NO
SO
WE
EA
C



F

111111
100001
111111
