


N
S
C

111111
100001
111111
