


NO ./maps/texture/brick.xpm
SO ./maps/texture/brick.xpm
WE ./maps/texture/brick.xpm
EA ./maps/texture/brick.xpm
C 123/123/123



F 123/123/123

111111
100001
111111
