NO
SO
WE

F
C

11111
10001
11111
