NO maps/texture/brick.xpm

11111111111111111111111
10000000000000000000001
11111111111111111111111
SO maps/texture/brick.xpm
