NO /path1 /path2


SO /path

11111111
