NS


ON

    c
f
WA

11111
10001
11111
