NO
ND
NP
SO
WE
EW

111111111111111
